###################################
#   #       #     #       #       #
# # # ##### # ### # ##### # ##### #
# # #     # # #   #     # #   #   #
# # ##### # # # ####### # ### # ###
# #   #   #   # #     # #   #   # #
# ### # ##### # # ### # ### ##### #
# #   # #   # # # #   #   #     # #
# # ### # # # ### # ##### ##### # #
# # # # # # #   # #   #   #   # # #
# # # # # # ### # ### # ### # # # #
# #   # #   #   #   # #   # #   # #
# ##### ##### ##### # ### # #####
# #   #   #   #     #   # # #   # #
# # # ### # ### ##### # # # # # # #
#   #     #     #     #   #   #   #
###################################