###################################
#                                 #
# # # ##### # ### # ##### # ##### #
# # #     # # #         # #   #   #
# # ##### # # # ####### # ### # ###
# #   #   #   #       # #   #   # #
# ### # ##### # # ### # ### ##### #
# #   # #   # # # #   #   #     # #
# # ### # # # ### # ##### ##### # #
# # # # # # #   # #   #   #   # # #
# # # # # # ### # ### # ### # # # #
# #   # #   #   #   # #   # #   # #
# ##### ##### ##### # ### # #####
# #   #   #   #     #   # # #   # #
# # # ### # ### ##### # # # # # # #
#   #     #     #     #   #   #   #
###################################